2-input a
MaxSteps = 50
NumShells=20
Rows = 8
Cols =10
##########
#   1    #
# 1      #
#        #
#   @    #
#  2     #
#1  #    #
########## 