3-input c
MaxSteps = 50
NumShells=20
Rows = 8
Cols =10
##########
#        #
#   12   #
#   12   #
#   @    #
#  21    #
#   #    #
########## 